NO  ./textures/texture1.png    
SO  ./textures/texture2.png   
WE  ./textures/texture3.png
EA  ./textures/texture4.png  

F 25,20,55
C 0,200,255

        1111111111111111111111111
        10000000001100I0000000I01
        10110000011100000000I0001
        10010000000C0000000000001
111111111011000001110I00000000I01
10000000000C00000111C11111C111111
11110000000111C11100000010001
111100000111110111000000100I1
11111C111111110111000000CI001
11110000011111000C00000010001
111100000111110111010100100011
11011C111110101011100000C0I0I1
10000000000000000C000000100011
10000000000000001101010010001
11000001110101011111011110N0111
11110111 1110101 101111010001
11111111 1111111 111111111111